11111111
10001001
10100001
10001001
11111111