NO ./textures/rooms/desertwallN.xpm
SO ./textures/rooms/desertwallS.xpm
WE ./textures/rooms/desertwallW.xpm
EA ./textures/rooms/desertwallE.xpm
F 237,201,175
C 135,206,235

1111
1001
1001111
1000001
100W001
1111111
