NO ./textures/rooms/desertwallN.xpm
SO ./textures/rooms/desertwallS.xpm
WE ./textures/rooms/desertwallW.xpm
EA ./textures/rooms/desertwallE.xpm
F 237,201,175
C 135,206,235

111111111
100000001
101110101
101000101
10100E101
101000101
101110101
100000001
111111111
