NO ./textures/rooms/north.xpm
SO ./textures/rooms/south.xpm
WE ./textures/rooms/west.xpm
EA ./textures/rooms/east.xpm

111111
100N01
111111
